%%%%%%%%%%%%%%%%%%%%
%.  .  .  .  .  . P%
%.                 %
%.                 %
%.                 %
%.  .    .      .  %
%%%%%%%%%%%%%%%%%%%%
